<?xml version="1.0" encoding="UTF-8"?>
<?PowerDesigner AppLocale="UTF16" ID="{4B0A5A42-A907-48E0-9057-F504BB09F6BC}" Label="" LastModificationDate="1254491150" Name="XMLModel_2" Objects="5" Symbols="0" Target="XML Schema Definition 1.0" Type="{029EAF0C-06EE-4282-8CB2-D70732085DEF}" signature="XSM_MODEL" version="15.0.0.2613"?>
<!-- do not edit this file -->

<Model xmlns:a="attribute" xmlns:c="collection" xmlns:o="object">

<o:RootObject Id="o1">
<c:Children>
<o:Model Id="o2">
<a:ObjectID>4B0A5A42-A907-48E0-9057-F504BB09F6BC</a:ObjectID>
<a:Name>XMLModel_2</a:Name>
<a:Code>XMLModel_2</a:Code>
<a:CreationDate>1254491150</a:CreationDate>
<a:Creator>manzamb</a:Creator>
<a:ModificationDate>1254491150</a:ModificationDate>
<a:Modifier>manzamb</a:Modifier>
<a:PackageOptionsText>[FolderOptions]

[FolderOptions\XML Schema Objects]
GenerationCheckModel=Yes
GenerationPath=
GenerationOptions=
GenerationTasks=
GenerationTargets=
GenerationSelections=

[FolderOptions\XML Model]</a:PackageOptionsText>
<a:ModelOptionsText>[ModelOptions]

[ModelOptions\XSM options]
CaseSensitive=No
DisplayName=Yes
EnableTrans=No
EnableRequirements=No

[ModelOptions\XSM options\NamingOptionsTemplates]

[ModelOptions\XSM options\ClssNamingOptions]

[ModelOptions\XSM options\ClssNamingOptions\SIMPLETYPE]

[ModelOptions\XSM options\ClssNamingOptions\SIMPLETYPE\Name]
Template=
MaxLen=254
Case=M
ValidChar=
InvldChar=
AllValid=Yes
NoAccent=No
DefaultChar=_
Script=.convert_name(%Name%,&quot;_&quot;)
ConvTable=

[ModelOptions\XSM options\ClssNamingOptions\SIMPLETYPE\Code]
Template=
MaxLen=254
Case=M
ValidChar=&#39;a&#39;-&#39;z&#39;,&#39;A&#39;-&#39;Z&#39;,&#39;0&#39;-&#39;9&#39;,&quot;_&quot;
InvldChar=
AllValid=No
NoAccent=Yes
DefaultChar=_
Script=.convert_code(%Code%,&quot; &quot;)
ConvTable=

[ModelOptions\XSM options\ClssNamingOptions\COMPLEXTYPE]

[ModelOptions\XSM options\ClssNamingOptions\COMPLEXTYPE\Name]
Template=
MaxLen=254
Case=M
ValidChar=
InvldChar=
AllValid=Yes
NoAccent=No
DefaultChar=_
Script=.convert_name(%Name%,&quot;_&quot;)
ConvTable=

[ModelOptions\XSM options\ClssNamingOptions\COMPLEXTYPE\Code]
Template=
MaxLen=254
Case=M
ValidChar=&#39;a&#39;-&#39;z&#39;,&#39;A&#39;-&#39;Z&#39;,&#39;0&#39;-&#39;9&#39;,&quot;_&quot;
InvldChar=
AllValid=No
NoAccent=Yes
DefaultChar=_
Script=.convert_code(%Code%,&quot; &quot;)
ConvTable=

[ModelOptions\XSM options\ClssNamingOptions\ELEMENT]

[ModelOptions\XSM options\ClssNamingOptions\ELEMENT\Name]
Template=
MaxLen=254
Case=M
ValidChar=
InvldChar=
AllValid=Yes
NoAccent=No
DefaultChar=_
Script=.convert_name(%Name%,&quot;_&quot;)
ConvTable=

[ModelOptions\XSM options\ClssNamingOptions\ELEMENT\Code]
Template=
MaxLen=254
Case=M
ValidChar=&#39;a&#39;-&#39;z&#39;,&#39;A&#39;-&#39;Z&#39;,&#39;0&#39;-&#39;9&#39;,&quot;_&quot;
InvldChar=
AllValid=No
NoAccent=Yes
DefaultChar=_
Script=.convert_code(%Code%,&quot; &quot;)
ConvTable=

[ModelOptions\XSM options\ClssNamingOptions\ATTRIBUTE]

[ModelOptions\XSM options\ClssNamingOptions\ATTRIBUTE\Name]
Template=
MaxLen=254
Case=M
ValidChar=
InvldChar=
AllValid=Yes
NoAccent=No
DefaultChar=_
Script=.convert_name(%Name%,&quot;_&quot;)
ConvTable=

[ModelOptions\XSM options\ClssNamingOptions\ATTRIBUTE\Code]
Template=
MaxLen=254
Case=M
ValidChar=&#39;a&#39;-&#39;z&#39;,&#39;A&#39;-&#39;Z&#39;,&#39;0&#39;-&#39;9&#39;,&quot;_&quot;
InvldChar=
AllValid=No
NoAccent=Yes
DefaultChar=_
Script=.convert_code(%Code%,&quot; &quot;)
ConvTable=

[ModelOptions\XSM options\ClssNamingOptions\GROUP]

[ModelOptions\XSM options\ClssNamingOptions\GROUP\Name]
Template=
MaxLen=254
Case=M
ValidChar=
InvldChar=
AllValid=Yes
NoAccent=No
DefaultChar=_
Script=.convert_name(%Name%,&quot;_&quot;)
ConvTable=

[ModelOptions\XSM options\ClssNamingOptions\GROUP\Code]
Template=
MaxLen=254
Case=M
ValidChar=&#39;a&#39;-&#39;z&#39;,&#39;A&#39;-&#39;Z&#39;,&#39;0&#39;-&#39;9&#39;,&quot;_&quot;
InvldChar=
AllValid=No
NoAccent=Yes
DefaultChar=_
Script=.convert_code(%Code%,&quot; &quot;)
ConvTable=

[ModelOptions\XSM options\ClssNamingOptions\NOTATION]

[ModelOptions\XSM options\ClssNamingOptions\NOTATION\Name]
Template=
MaxLen=254
Case=M
ValidChar=
InvldChar=
AllValid=Yes
NoAccent=No
DefaultChar=_
Script=.convert_name(%Name%,&quot;_&quot;)
ConvTable=

[ModelOptions\XSM options\ClssNamingOptions\NOTATION\Code]
Template=
MaxLen=254
Case=M
ValidChar=&#39;a&#39;-&#39;z&#39;,&#39;A&#39;-&#39;Z&#39;,&#39;0&#39;-&#39;9&#39;,&quot;_&quot;
InvldChar=
AllValid=No
NoAccent=Yes
DefaultChar=_
Script=.convert_code(%Code%,&quot; &quot;)
ConvTable=

[ModelOptions\XSM options\ClssNamingOptions\ENTITY]

[ModelOptions\XSM options\ClssNamingOptions\ENTITY\Name]
Template=
MaxLen=254
Case=M
ValidChar=
InvldChar=
AllValid=Yes
NoAccent=No
DefaultChar=_
Script=.convert_name(%Name%,&quot;_&quot;)
ConvTable=

[ModelOptions\XSM options\ClssNamingOptions\ENTITY\Code]
Template=
MaxLen=254
Case=M
ValidChar=&#39;a&#39;-&#39;z&#39;,&#39;A&#39;-&#39;Z&#39;,&#39;0&#39;-&#39;9&#39;,&quot;_&quot;
InvldChar=
AllValid=No
NoAccent=Yes
DefaultChar=_
Script=.convert_code(%Code%,&quot; &quot;)
ConvTable=

[ModelOptions\XSM options\ClssNamingOptions\FILO]

[ModelOptions\XSM options\ClssNamingOptions\FILO\Name]
Template=
MaxLen=254
Case=M
ValidChar=
InvldChar=&quot;\/:*?&lt;&gt;|&quot;
AllValid=Yes
NoAccent=No
DefaultChar=_
Script=.convert_name(%Name%,&quot;_&quot;)
ConvTable=

[ModelOptions\XSM options\ClssNamingOptions\FILO\Code]
Template=
MaxLen=254
Case=M
ValidChar=&#39;a&#39;-&#39;z&#39;,&#39;A&#39;-&#39;Z&#39;,&#39;0&#39;-&#39;9&#39;,&quot;_. &quot;
InvldChar=
AllValid=No
NoAccent=Yes
DefaultChar=_
Script=.convert_code(%Code%,&quot; &quot;)
ConvTable=

[ModelOptions\XSM options\ClssNamingOptions\FRMEOBJ]

[ModelOptions\XSM options\ClssNamingOptions\FRMEOBJ\Name]
Template=
MaxLen=254
Case=M
ValidChar=
InvldChar=
AllValid=Yes
NoAccent=No
DefaultChar=_
Script=.convert_name(%Name%,&quot;_&quot;)
ConvTable=

[ModelOptions\XSM options\ClssNamingOptions\FRMEOBJ\Code]
Template=
MaxLen=254
Case=M
ValidChar=&#39;a&#39;-&#39;z&#39;,&#39;A&#39;-&#39;Z&#39;,&#39;0&#39;-&#39;9&#39;,&quot;_&quot;
InvldChar=
AllValid=No
NoAccent=Yes
DefaultChar=_
Script=.convert_code(%Code%,&quot; &quot;)
ConvTable=

[ModelOptions\XSM options\ClssNamingOptions\FRMELNK]

[ModelOptions\XSM options\ClssNamingOptions\FRMELNK\Name]
Template=
MaxLen=254
Case=M
ValidChar=
InvldChar=
AllValid=Yes
NoAccent=No
DefaultChar=_
Script=.convert_name(%Name%,&quot;_&quot;)
ConvTable=

[ModelOptions\XSM options\ClssNamingOptions\FRMELNK\Code]
Template=
MaxLen=254
Case=M
ValidChar=&#39;a&#39;-&#39;z&#39;,&#39;A&#39;-&#39;Z&#39;,&#39;0&#39;-&#39;9&#39;,&quot;_&quot;
InvldChar=
AllValid=No
NoAccent=Yes
DefaultChar=_
Script=.convert_code(%Code%,&quot; &quot;)
ConvTable=

[ModelOptions\XSM options\ClssNamingOptions\DefaultClass]

[ModelOptions\XSM options\ClssNamingOptions\DefaultClass\Name]
Template=
MaxLen=254
Case=M
ValidChar=
InvldChar=
AllValid=Yes
NoAccent=No
DefaultChar=_
Script=.convert_name(%Name%,&quot;_&quot;)
ConvTable=

[ModelOptions\XSM options\ClssNamingOptions\DefaultClass\Code]
Template=
MaxLen=254
Case=M
ValidChar=&#39;a&#39;-&#39;z&#39;,&#39;A&#39;-&#39;Z&#39;,&#39;0&#39;-&#39;9&#39;,&quot;_&quot;
InvldChar=
AllValid=No
NoAccent=Yes
DefaultChar=_
Script=.convert_code(%Code%,&quot; &quot;)
ConvTable=

[ModelOptions\Generate]

[ModelOptions\Generate\Xsm]
XMLMapping=No</a:ModelOptionsText>
<a:ElementFormDefault>qualified</a:ElementFormDefault>
<a:Namespaces>http://www.w3.org/2001/XMLSchema	xs</a:Namespaces>
<c:SchemaLanguage>
<o:Shortcut Id="o3">
<a:ObjectID>8AD88268-358B-4AB7-8DFB-D53CC707A88E</a:ObjectID>
<a:Name>XML Schema Definition 1.0</a:Name>
<a:Code>XML Schema Definition</a:Code>
<a:CreationDate>1254491150</a:CreationDate>
<a:Creator>manzamb</a:Creator>
<a:ModificationDate>1254491150</a:ModificationDate>
<a:Modifier>manzamb</a:Modifier>
<a:TargetStereotype/>
<a:TargetID>35C78E17-809A-4234-A469-846E88A581E9</a:TargetID>
<a:TargetClassID>40249E0F-D7DA-41DC-8056-6199DCA3A7D8</a:TargetClassID>
</o:Shortcut>
</c:SchemaLanguage>
<c:XsmDiagrams>
<o:XMLDiagram Id="o4">
<a:ObjectID>6866F398-0D83-4F2E-A6FC-E13BB548C551</a:ObjectID>
<a:Name>Diagram_1</a:Name>
<a:Code>Diagram_1</a:Code>
<a:CreationDate>1254491150</a:CreationDate>
<a:Creator>manzamb</a:Creator>
<a:ModificationDate>1254491150</a:ModificationDate>
<a:Modifier>manzamb</a:Modifier>
<a:DisplayPreferences>[DisplayPreferences]

[DisplayPreferences\XSM]

[DisplayPreferences\General]
Adjust to text=Yes
Snap Grid=No
Constrain Labels=Yes
Display Grid=No
Show Page Delimiter=Yes
Grid size=800
Graphic unit=2
Window color=255 255 255
Background image=
Background mode=8
Watermark image=
Watermark mode=8
Show watermark on screen=No
Gradient mode=0
Gradient end color=255 255 255
Show Swimlane=No
SwimlaneVert=Yes
TreeVert=No
CompDark=0

[DisplayPreferences\Object]
Mode=0
Trunc Length=80
Word Length=80
Word Text=!&quot;&quot;#$%&amp;&#39;()*+,-./:;&lt;=&gt;?@[\]^_`{|}~
Shortcut IntIcon=Yes
Shortcut IntLoct=Yes
Shortcut IntFullPath=No
Shortcut IntLastPackage=Yes
Shortcut ExtIcon=Yes
Shortcut ExtLoct=No
Shortcut ExtFullPath=No
Shortcut ExtLastPackage=Yes
Shortcut ExtIncludeModl=Yes
EObjShowStrn=Yes
ExtendedObject.Comment=No
ExtendedObject.IconPicture=No
ExtendedObject_SymbolLayout=
ELnkShowStrn=Yes
ELnkShowName=Yes
ExtendedLink_SymbolLayout=
File Location=No
Display Model Version=Yes
GroupParticle.IconPicture=No
GroupParticle_SymbolLayout=
Element.IconPicture=No
Element_SymbolLayout=
ComplexType.IconPicture=No
ComplexType_SymbolLayout=
SimpleType.IconPicture=No
SimpleType_SymbolLayout=
Any.IconPicture=No
Any_SymbolLayout=
Group.IconPicture=No
Group_SymbolLayout=
FileObject.IconPicture=No
FileObject_SymbolLayout=
ElementStrn=Yes
Element.Comment=No
ElementType=Yes
ElementAttr=Yes
ElementAttrDttp=Yes
ElementDLim=Yes
ElementNb=5
ElementXPath=2
ComplexTypeStrn=Yes
ComplexType.Comment=No
ComplexTypeType=Yes
ComplexTypeAttr=Yes
ComplexTypeDLim=Yes
ComplexTypeNb=5
ComplexTypeAttrDttp=Yes
SimpleTypeStrn=Yes
GroupStrn=Yes
Group.Comment=No
AnyStrn=Yes

[DisplayPreferences\Symbol]

[DisplayPreferences\Symbol\FRMEOBJ]
STRNFont=Arial,8,N
STRNFont color=0, 0, 0
DISPNAMEFont=Arial,8,N
DISPNAMEFont color=0, 0, 0
LABLFont=Arial,8,N
LABLFont color=0, 0, 0
AutoAdjustToText=Yes
Keep aspect=No
Keep center=No
Keep size=No
Width=6000
Height=2000
Brush color=255 255 255
Fill Color=Yes
Brush style=6
Brush bitmap mode=12
Brush gradient mode=64
Brush gradient color=192 192 192
Brush background image=
Custom shape=
Custom text mode=0
Pen=1 0 255 128 128
Shadow color=192 192 192
Shadow=0

[DisplayPreferences\Symbol\FRMELNK]
CENTERFont=Arial,8,N
CENTERFont color=0, 0, 0
Line style=2
AutoAdjustToText=Yes
Keep aspect=No
Keep center=No
Keep size=No
Brush color=255 255 255
Fill Color=Yes
Brush style=1
Brush bitmap mode=12
Brush gradient mode=0
Brush gradient color=118 118 118
Brush background image=
Custom shape=
Custom text mode=0
Pen=1 0 128 128 255
Shadow color=192 192 192
Shadow=0

[DisplayPreferences\Symbol\GROUPPARTICLE]
XTYPFont=Arial,8,N
XTYPFont color=0 0 0
AutoAdjustToText=No
Keep aspect=Yes
Keep center=Yes
Keep size=Yes
Width=1500
Height=1500
Brush color=255 255 255
Fill Color=Yes
Brush style=6
Brush bitmap mode=12
Brush gradient mode=513
Brush gradient color=255 244 204
Brush background image=
Custom shape=
Custom text mode=0
Pen=1 0 255 0 0
Shadow color=192 192 192
Shadow=0

[DisplayPreferences\Symbol\ELEMENT]
STRNFont=Arial,8,N
STRNFont color=0 0 0
DNAMFont=Arial,8,N
DNAMFont color=0 0 0
DISPTYPEFont=Arial,8,N
DISPTYPEFont color=0 0 0
XPTHFont=Arial,8,N
XPTHFont color=0 0 0
AttributesFont=Arial,8,N
AttributesFont color=0 0 0
LABLFont=Arial,8,N
LABLFont color=0 0 0
AutoAdjustToText=Yes
Keep aspect=No
Keep center=No
Keep size=No
Width=3000
Height=1500
Brush color=255 207 159
Fill Color=Yes
Brush style=6
Brush bitmap mode=12
Brush gradient mode=65
Brush gradient color=255 255 255
Brush background image=
Custom shape=
Custom text mode=0
Pen=1 0 128 64 64
Shadow color=192 192 192
Shadow=0

[DisplayPreferences\Symbol\COMPLEXTYPE]
STRNFont=Arial,8,N
STRNFont color=0 0 0
DNAMFont=Arial,8,N
DNAMFont color=0 0 0
DTYPENAMEFont=Arial,8,N
DTYPENAMEFont color=0 0 0
AttributesFont=Arial,8,N
AttributesFont color=0 0 0
LABLFont=Arial,8,N
LABLFont color=0 0 0
AutoAdjustToText=Yes
Keep aspect=No
Keep center=No
Keep size=No
Width=3000
Height=1500
Brush color=242 230 210
Fill Color=Yes
Brush style=6
Brush bitmap mode=12
Brush gradient mode=65
Brush gradient color=255 255 255
Brush background image=
Custom shape=
Custom text mode=0
Pen=1 0 128 0 64
Shadow color=192 192 192
Shadow=0

[DisplayPreferences\Symbol\SIMPLETYPE]
STRNFont=Arial,8,N
STRNFont color=0, 0, 0
DNAMFont=Arial,8,N
DNAMFont color=0, 0, 0
AutoAdjustToText=Yes
Keep aspect=No
Keep center=No
Keep size=No
Width=8000
Height=4000
Brush color=255 244 204
Fill Color=Yes
Brush style=6
Brush bitmap mode=12
Brush gradient mode=65
Brush gradient color=255 255 255
Brush background image=
Custom shape=
Custom text mode=0
Pen=1 0 0 128 0
Shadow color=192 192 192
Shadow=0

[DisplayPreferences\Symbol\ANY]
STRNFont=Arial,8,N
STRNFont color=0 0 0
DISPANYFont=Arial,8,N
DISPANYFont color=0 0 0
AutoAdjustToText=Yes
Keep aspect=No
Keep center=No
Keep size=No
Width=3000
Height=1500
Brush color=230 198 162
Fill Color=Yes
Brush style=6
Brush bitmap mode=12
Brush gradient mode=65
Brush gradient color=255 255 255
Brush background image=
Custom shape=
Custom text mode=0
Pen=1 0 255 128 0
Shadow color=192 192 192
Shadow=0

[DisplayPreferences\Symbol\GROUP]
STRNFont=Arial,8,N
STRNFont color=0 0 0
DNAMFont=Arial,8,N
DNAMFont color=0 0 0
LABLFont=Arial,8,N
LABLFont color=0 0 0
AutoAdjustToText=Yes
Keep aspect=No
Keep center=No
Keep size=No
Width=3000
Height=1500
Brush color=255 244 204
Fill Color=Yes
Brush style=6
Brush bitmap mode=12
Brush gradient mode=65
Brush gradient color=255 255 255
Brush background image=
Custom shape=
Custom text mode=0
Pen=1 0 128 0 0
Shadow color=192 192 192
Shadow=0

[DisplayPreferences\Symbol\COLLLINK]
Line style=2
Pen=1 0 0 128 0
Shadow color=192 192 192
Shadow=0

[DisplayPreferences\Symbol\FILO]
NAMEFont=Arial,8,N
NAMEFont color=0, 0, 0
AutoAdjustToText=Yes
Keep aspect=Yes
Keep center=Yes
Keep size=No
Width=2400
Height=2400
Brush color=255 255 255
Fill Color=No
Brush style=1
Brush bitmap mode=12
Brush gradient mode=0
Brush gradient color=118 118 118
Brush background image=
Custom shape=
Custom text mode=0
Pen=1 0 0 0 255
Shadow color=192 192 192
Shadow=0

[DisplayPreferences\Symbol\USRDEPD]
OBJXSTRFont=Arial,8,N
OBJXSTRFont color=0, 0, 0
Line style=2
AutoAdjustToText=Yes
Keep aspect=No
Keep center=No
Keep size=No
Brush color=255 255 255
Fill Color=Yes
Brush style=1
Brush bitmap mode=12
Brush gradient mode=0
Brush gradient color=118 118 118
Brush background image=
Custom shape=
Custom text mode=0
Pen=2 0 128 128 255
Shadow color=192 192 192
Shadow=0

[DisplayPreferences\Symbol\Free Symbol]
Free TextFont=Arial,8,N
Free TextFont color=0, 0, 0
Line style=2
AutoAdjustToText=Yes
Keep aspect=No
Keep center=No
Keep size=No
Brush color=255 255 255
Fill Color=Yes
Brush style=1
Brush bitmap mode=12
Brush gradient mode=0
Brush gradient color=118 118 118
Brush background image=
Custom shape=
Custom text mode=0
Pen=1 0 0 0 255
Shadow color=192 192 192
Shadow=0</a:DisplayPreferences>
<a:PaperSize>(8500, 11000)</a:PaperSize>
<a:PageMargins>((315,354), (433,354))</a:PageMargins>
<a:PageOrientation>1</a:PageOrientation>
<a:PaperSource>7</a:PaperSource>
</o:XMLDiagram>
</c:XsmDiagrams>
<c:DefaultDiagram>
<o:XMLDiagram Ref="o4"/>
</c:DefaultDiagram>
<c:XmlNamespaces>
<o:XmlNamespace Id="o5">
<a:ObjectID>1D9B3387-BCB0-45D1-90A8-0509D68C223A</a:ObjectID>
<a:CreationDate>1254491150</a:CreationDate>
<a:Creator>manzamb</a:Creator>
<a:ModificationDate>1254491150</a:ModificationDate>
<a:Modifier>manzamb</a:Modifier>
<a:Prefix>xs</a:Prefix>
<a:Uri>http://www.w3.org/2001/XMLSchema</a:Uri>
</o:XmlNamespace>
</c:XmlNamespaces>
<c:TargetModels>
<o:TargetModel Id="o6">
<a:ObjectID>11BA02DC-1F25-4E82-B34F-A039D6A477D6</a:ObjectID>
<a:Name>XML Schema Definition 1.0</a:Name>
<a:Code>XML Schema Definition</a:Code>
<a:CreationDate>1254491150</a:CreationDate>
<a:Creator>manzamb</a:Creator>
<a:ModificationDate>1254491150</a:ModificationDate>
<a:Modifier>manzamb</a:Modifier>
<a:TargetModelURL>file:///%_XMLLANG%/xsd.xsl</a:TargetModelURL>
<a:TargetModelID>35C78E17-809A-4234-A469-846E88A581E9</a:TargetModelID>
<a:TargetModelClassID>40249E0F-D7DA-41DC-8056-6199DCA3A7D8</a:TargetModelClassID>
<c:SessionShortcuts>
<o:Shortcut Ref="o3"/>
</c:SessionShortcuts>
</o:TargetModel>
</c:TargetModels>
</o:Model>
</c:Children>
</o:RootObject>

</Model>